3 13 31
###############################
#p     ** *    *   *  * * *   #
#  			      #
#  x*     	   3  * 2 * * #
#  			      #
#f         x **  *  *   1     #
#  			      #
#*  *      *  *3     *        #
# # # # #*# # # #*#*# # # # # #
#*    **  *       *           #
# #*# # # # # # #*# # # # # # #
#         1 *   *  *          #
###############################